PxlSafe - Tools for Video Editors | @DavudCokic | pxlsafe.com
Ecom Efficiency | Antoine | ecomefficiency.com
AI Labs | s | tradenote.io
Shopquantum | SHOPQUANTUM.AI | platform.bestfulfill.com
Firdavs Shodiev | @dev_firdavs | www.fapihub.com
Syntha AI | @den_vol | syntha.ai
SFX Engine | @rogtukuba | sfxengine.com
Unnamed Company | FaHaD Mohammed | null
Prymatica | @RobbyFrank_ | www.prymatica.com
Cite Me | @seoreadjusted | citeme.app
HuskyApp | null, | husky-app.com
Fast Flow | N/A | fastflow.dev
Produktly | N/A | produktly.com
Solmate | null, | null
Dropkiller | N/A | dropkiller.com
Unnamed Company | N/A | null
Code Market | null, | code.market
GovEx AI | null, | govexai.com
AiStudios | null, | tryaistudios.com
Documind Ltd | null, | documind.chat
Esferas.io | N/A | esferas.io
Lexicon Labs s.r.o. | N/A | lexiconlabs.ai
Pro Photo | null, | prophoto.app
Neume | N/A | neume.io
tinyScale AI | null, | tinyscale.ai
Publicview | null, | publicview.ai
GOimagen | null, | goimagen.com
ReLens AI | N/A | relens.ai
Z-Image.io | null, | z-image.io
DentAI | N/A | dentai.ai
Red Leg Dev, LLC | N/A | redleg.dev
Agence web Abstract27 | N/A | fr.abstract27.com
Orel Zilberman, LLC | N/A | substack.com
MassInvoices | N/A | massinvoices.com
Local SEO Bot | N/A | localseobot.com
Docswrite | null, | docswrite.com
AskCory | null, | askcory.ai
Ecom Tools | null, | ecom-tools.com
Mig | N/A | mig.lemonsqueezy.com
PxlSafe | N/A | pxlsafe.com
Formflow | null, | getformflow.io
APPRENDRE MAKE | N/A | apprendre-make.com
easyflip | null, | easyflip.ai
STOIC MANUAL LLC | N/A | thestoicmanual.com
The Brazil Girl | N/A | thebrazilgirl.com
Yoga Sunrise Poitiers | N/A | yogasunrisepoitiers.fr
shownotes.io | null, | shownotes.io
One Mint | N/A | onemint.io
Colibri (cadastre.io) SAS WERY SaaS | N/A | cadastre.io
Bali Villa Hub | N/A | balivillahub.com
LocalEmpire | N/A | localempire.co
Handwritten Signature Generator | @jsuodenjoki | handwrittensignaturegenerator.com
DOGALYIR LTD | Carmelo Campos | dogalyir.com
Synta | null, | synta.io
ChatDash, LLC | N/A | chat-dash.com
Abstract27 Ltd | N/A | abstract27.com
Nocodable Components | null, | null
Work With Alex V | N/A | workwithalexv.com
QuitCorn | null, | quitcorn.app
Fran√ßaisalondres.com | N/A | francaisalondres.com